Quercus rotundifolia - Carvalho
Urtica dioica - Urtiga
Dactylis glomerata - Aveia-malhada
Plantago lanceolata - Tanchagem-maior
Achillea millefolium - Milefólio
Trifolium repens - Trevo-branco
Holcus lanatus - Aveia-das-ervas-lanas
Ranunculus repens - Ranúnculo-repentino
Quercus robur - Carvalho-roble
Festuca rubra - Festuca-vermelha
Fraxinus excelsior - Freixo-comum
Cirsium arvense - Cardo-dos-campos
Trifolium pratense - Trevo-dos-prados
Fagus sylvatica - Faia-comum
Juncus effusus - Junco
Ranunculus acris - Ranúnculo-agreste
Crataegus monogyna - Espinheiro-alvar
Rumex acetosa - Azedas
Calluna vulgaris - Urze
Filipendula ulmaria - Ulmeira
Corylus avellana - Avelãzeira
Phragmites australis - Caniço
Glechoma hederacea - Túlia
Agrostis capillaris - Agrostide
Anthoxanthum odoratum - Hierochloe odorata
Hedera helix - Hera
Agrostis stolonifera - Agrostide-estolonífera
Plantago major - Tanchagem-maior
Lotus corniculatus - Trevo-corniculado
Sorbus aucuparia - Sorveira
Poa trivialis - Grama-trepadeira
Galium aparine - Erva-picheleira
Potentilla erecta - Tormentilha
Pinus sylvestris - Pinheiro-silvestre
Prunella vulgaris - Prunela
Arrhenatherum elatius - Grama alta
Lolium perenne - Lolium-perene
Anthriscus sylvestris - Cerfeia-silvestre
Quercus suber - Sobreiro
Prunus spinosa - Espinheiro-alvar
Heracleum sphondylium - Bardana
Deschampsia cespitosa - Cespitosa
Alnus glutinosa - Amieiro
Sambucus nigra - Sabugueiro
Molinia caerulea - Molínia
Acer pseudoplatanus - Falso plátano
Cirsium vulgare - Cardo-comum
Geranium robertianum - Gerânio-robertiano
Poa pratensis - Grama-de-prados
Cirsium palustre - Cardo-palustre
Poa annua - Grama-anual
Betula pendula - Vidoeiro
Alliaria petiolata - Erva-alheira
Bellis perennis - Margarida-comum
Vaccinium myrtillus - Mirtilo
Pteridium aquilinum - Feto-aquilino
Veronica chamaedrys - Verónica-das-urzes
Lapsana communis - Lapsana-comum
Equisetum arvense - Cavalinha
Angelica sylvestris - Angélica-silvestre
Cistus ladanifer - Jara-prateada
Rosmarinus officinalis - Alecrim
Acer platanoides - Bordo-norueguês
Lathyrus pratensis - Ervilha-dos-prados
Silene flos-cuculi - Silene
Pinus pinaster - Pinheiro-bravo
Picea abies - Abeto-comum
Hypericum perforatum - Hipérico
Daucus carota - Cenoura-silvestre
Cardamine pratensis - Cardamine-dos-prados
Geum urbanum - Erva-urbana
Populus tremula - Choupo-tremedor
Vicia cracca - Ervilha-de-cheiro
Phalaris arundinacea - Caniço-de-lugar
Juniperus communis - Zimbro
Elymus repens - Triticale-repentino
Galium verum - Dádiva-dos-pássaros
Lythrum salicaria - Salicária
Rumex acetosella - Azeda
Rumex obtusifolius - Paciência
Leucanthemum vulgare - Margarida-branca
Epilobium hirsutum - Epilóbio
Dryopteris filix-mas - Feto-macho
Artemisia vulgaris - Artemísia
Cornus sanguinea - Corniso-selvagem
Fragaria vesca - Morango-silvestre
Rumex crispus - Cártamo-azedo
Caltha palustris - Calta
Galium palustre - Dádiva-do-pântano
Polygonum aviculare - Rabo-de-gato
Tussilago farfara - Tussilagem
Stellaria media - Estrela-dos-campos
Triticum aestivum - Trigo
Iris pseudacorus - Lírio-amarelo
Rubus idaeus - Framboesa
Capsella bursa-pastoris - Bolsa-de-pastor
Lysimachia vulgaris - Loosestrife-comum
Jacobaea vulgaris - Arnica
Argentina anserina - Cabelos-de-vênus
Eupatorium cannabinum - Cânhamo-aquático
Medicago lupulina - Luzerna
Lonicera periclymenum - Madressilva
Solanum dulcamara - Beladona
Campanula rotundifolia - Campainhas
Calystegia sepium - Convolvulus
Phleum pratense - Faveiro
Carex flacca - Cégamo
Aegopodium podagraria - Pés-de-bode
Ilex aquifolium - Azevinho
Vicia sativa - Ervilha-silvestre
Lycopus europaeus - Lícopo
Stellaria graminea - Estrela-dos-prados
Betula pubescens - Vidoeiro-branco
Potentilla reptans - Potentilha-rasteira
Senecio vulgaris - Senécio
Convolvulus arvensis - Corriola
Bromus hordeaceus - Brômus
Athyrium filix-femina - Athyrium
Mentha aquatica - Hortelã-aquática
Acer campestre - Bordo-bravo
Centaurea jacea - Centáurea-menor
Ajuga reptans - Ajuga
Lamium galeobdolon - Lamium
Sonchus asper - Serralha
Prunus avium - Cerejeira-silvestre
Ligustrum vulgare - Ligustro
Salvia rosmarinus - Alecrim
Tanacetum vulgare - Crisântemo-malmequer
Silene dioica - Silene-dioico
Luzula campestris - Luzula-campestra
Primula veris - Primavera
Chelidonium majus - Celidônia
Oxalis acetosella - Trevo-azedo
Impatiens glandulifera - Balsamina
Carpinus betulus - Carvalho-alvarinho
Rosa canina - Roseira-brava
Pinus nigra - Pinheiro-negro
Juncus articulatus - Junco-articulado
Vicia sepium - Ervilha-dos-campos
Lamium purpureum - Lamium-roxo
Rubus fruticosus - Silvas
Frangula alnus - Espinheiro-negro
Crepis capillaris - Amor-dos-homens
Chenopodium album - Figueira-brava
Carex nigra - Carex-negra
Sonchus oleraceus - Serralha
Scorzoneroides autumnalis - Escorzonera
Brachypodium sylvaticum - Brachipódio
Alopecurus pratensis - Rabo-de-raposa
Glyceria fluitans - Glicerídeas
Olea europaea - Oliveira
Pinus halepensis - Pinheiro-de-alepo
Lotus pedunculatus - Trevo-de-pé-de-galinha
Stachys sylvatica - Betónica
Euonymus europaeus - Evónimo-europeu
Solidago virgaurea - Vara-de-ouro
Knautia arvensis - Escabiosa-dos-campos
Cytisus scoparius - Tojo
Succisa pratensis - Sucisa-dos-prados
Potentilla anserina - Pés-de-ganso
Galeopsis tetrahit - Urtiga-branca
Veronica officinalis - Veronica
Ranunculus flammula - Ranúnculo
Briza media - Trevo-de-ovelha
Viburnum opulus - Sanguinheira
Linaria vulgaris - Linária-comum
Cerastium fontanum - Orelhas-de-rato
Prunus padus - Tilheiro
Cynosurus cristatus - Barba-de-bode
Luzula multiflora - Luzula
Oryza sativa - Arroz
Galium mollugo - Erva-come-fel
Veronica persica - Veronica-persa
Equisetum fluviatile - Cavalinha-dos-riachos
Eriophorum angustifolium - Algodoeiro-angustifólio
Clematis vitalba - Clematite
Silene vulgaris - Silene-vulgar
Erigeron canadensis - Condrilhos-dos-campos
Vaccinium vitis-idaea - Uva-do-monte
Alisma plantago-aquatica - Cúndia
Myosotis scorpioides - Não-me-esqueças
Dryopteris carthusiana - Chorão
Euphorbia cyparissias - Eufórbia-ciparíssia
Carex panicea - Carriça-panícula
Typha latifolia - Espadeira
Bromus erectus - Bromo-erecto
Rabelera holostea - Sem-vergonha
Veronica arvensis - Verónica-dos-campos
Pinus pinea - Pinheiro-manso
Silene latifolia - Silene-dos-bosques
Reynoutria japonica - Reynoutria-japónica
Ranunculus bulbosus - Ranúnculo-tuberoso
Viola riviniana - Violeta-ruiva
Geranium dissectum - Gerânio-dissecto
Teucrium scorodonia - Escorodónia
Nardus stricta - Nardo-estreito
Trifolium dubium - Trevo-amarelo
Carex hirta - Carriça-dos-bosques
Equisetum palustre - Cavalinha-dos-pântanos
Matricaria discoidea - Camomila-discoideia
Pimpinella saxifraga - Pimpinela
Poa nemoralis - Pau-da-montanha
Carex rostrata - Carriça-de-bico
Empetrum nigrum - Urze-preta
Hordeum vulgare - Cevada
Agrimonia eupatoria - Agrimónia
Dryopteris dilatata - Chorão
Lonicera xylosteum - Madressilva
Lysimachia arvensis - Lysimachia
Festuca ovina - Feto-ovino
Bromus sterilis - Brome-estéril
Rubus caesius - Silvaninha
Lamium album - Lamio-branco
Lolium arundinaceum - Estrela-dos-campos
Myosotis arvensis - Não-me-esqueças-dos-campos
Castanea sativa - Castanheiro
Holcus mollis - Perna-de-pau
Origanum vulgare - Orégão
Symphytum officinale - Confrei
Lemna minor - Lentilha-de-água
Digitalis purpurea - Dedaleira
Pilosella officinarum - Não-me-esqueças-pequeno
Juncus bufonius - Junco
Erodium cicutarium - Gerânio-pelargonium
Valeriana officinalis - Valeriana
Papaver rhoeas - Papoila-dos-campos
Viburnum lantana - Sabugueiro-branco
Anthyllis vulneraria - Anthyllis
Echium vulgare - Víbora
Comarum palustre - Rúbia-dos-pântanos
Scrophularia nodosa - Escrofulária
Humulus lupulus - Lúpulo
Mercurialis perennis - Mercurialis
Convallaria majalis - Lírio-do-vale
Robinia pseudoacacia - Amor-de-hortelão
Persicaria maculosa - Persicária
Carex sylvatica - Carriça-dos-bosques
Ononis spinosa - Ononis
Neottia ovata - Neottia
Plantago media - Plantago
Epipactis helleborine - Helleborina-comum
Brachypodium pinnatum - Brachiária-de-folhas-compridas
Calamagrostis epigejos - Cana-comum
Cardamine hirsuta - Agrião-da-praia
Juncus conglomeratus - Junco-aglomerado
Quercus petraea - Sobreiro
Lactuca serriola - Alface-selvagem
Vaccinium uliginosum - Arando
Geranium molle - Gerânio-macio
Arum maculatum - Jarro
Geranium sylvaticum - Gerânio-silvestre
Sedum acre - Sedum
Polypodium vulgare - Polipódio-comum
Zea mays - Milho
Viola arvensis - Violeta-dos-campos
Achillea ptarmica - Mil-folhas
Veronica serpyllifolia - Verónica
Tilia cordata - Tília
Sonchus arvensis - Serralha
Pistacia lentiscus - Lentisco
Epilobium montanum - Salgueirinha-de-folhas-estreitas
Salix alba - Salgueiro-branco
Erica tetralix - Urze
Melampyrum pratense - Tinhosa
Tripleurospermum inodorum - Camomila-malmequer
Eleocharis palustris - Junça-dos-pântanos
Solanum nigrum - Erva-moira
Arenaria serpyllifolia - Arenária
Leontodon hispidus - Cerraja
Cerastium glomeratum - Colchico
Geum rivale - Geum-dos-ribeiros
Helianthemum nummularium - Soltos-dos-montes
Sagina procumbens - Sagina-procumbens
Glyceria maxima - Glicerínia-maior
Carex pilulifera - Carriço-dos-pinheirais
Lysimachia nummularia - Lysimachia-nummularia
Trifolium campestre - Trevo-dos-campos
Linum catharticum - Linho-purging
Galium odoratum - Gailho-cheiroso
Viola palustris - Violeta-dos-pântanos
Avenella flexuosa - Avenela-flexuosa
Alopecurus geniculatus - Alopecurus-geniculatus
Scirpus sylvaticus - Scirpo-dos-bosques
Luzula pilosa - Luzula-pilosa
Veronica beccabunga - Verónica-dos-charcos
Tragopogon pratensis - Serralha-dos-prados
Gymnadenia conopsea - Gymnadenia-conopsea
Medicago sativa - Luzerna
Polygonatum multiflorum - Polígono-das-flores-muitas
Circaea lutetiana - Circaea-lutetiana
Juncus inflexus - Junco-inflexo
Anacamptis pyramidalis - Orquídea-piramidal
Clinopodium vulgare - Orégão-silvestre
Rhinanthus minor - Rinanto-menor
Eriophorum vaginatum - Eriophorum-vaginatum
Carex leporina - Carriço-do-coelho
Sambucus racemosa - Sabugueiro-dos-pântanos
Dactylorhiza maculata - Orquídea-maculada
Galium album - Gailho
Stachys palustris - Betónica-dos-pântanos
Sparganium erectum - Espargânia-ereta
Betonica officinalis - Betônica
Lavandula stoechas - Lavanda
Dipsacus fullonum - Cardo-de-cardadores
Menyanthes trifoliata - Três-folhas
Sisymbrium officinale - Mostarda-silvestre
Maianthemum bifolium - Falso-lírio-do-vale
Agrostis canina - Capim-para-cães
Euphorbia helioscopia - Eufórbia-cabra-leiteira
Ulmus glabra - Olmo-comum
Phaseolus vulgaris - Feijão
Ulex europaeus - Tojo
Carex arenaria - Cariosa-arenária
Erigeron annuus - Verbasco
Trifolium arvense - Trevo-dos-campos
Epilobium palustre - Epilóbio-dos-pântanos
Carex acutiformis - Cariosa
Saponaria officinalis - Saponária
Carex echinata - Cariosa
Centaurea scabiosa - Escabiosa
Cichorium intybus - Chicória-amarga
Scutellaria galericulata - Escutelária
Trisetum flavescens - Trisetum-amarelo
Eryngium campestre - Cardo-campestre
Vicia hirsuta - Ervilha-pilosa
Juncus acutiflorus - Juncel
Alnus incana - Amieiro
Salvia pratensis - Salva-comum
Asplenium trichomanes - Capilé
Drosera rotundifolia - Orvalhinha-redonda
Quercus pubescens - Carvalho-alvarinho
Draba verna - Draba-da-primavera
Galium saxatile - Gália-dos-rochedos
Paris quadrifolia - Paris-de-quatro-folhas
Gnaphalium uliginosum - Nabalhaça
Fallopia convolvulus - Convolvulus-dos-campos
Trifolium medium - Trevo-de-meio
Danthonia decumbens - Danthonia-deitada
Verbascum thapsus - Candeia
Arctium minus - Bardana-menor
Lupinus polyphyllus - Lupino-polífilo
Melilotus albus - Meliloto-branco
Ulmus minor - Olmo
Vinca minor - Vinca-miúda
Equisetum sylvaticum - Cavalinha-dos-bosques
Polygala vulgaris - Polígala-vulgar
Parnassia palustris - Parnássia-dos-pântanos
Pastinaca sativa - Pastinaca-selvagem
Teucrium chamaedrys - Germandrina
Arabidopsis thaliana - Arabidopsis
Cirsium oleraceum - Cardo-oleiro
Moehringia trinervia - Moehringia-de-três-nervuras
Allium ursinum - Alho-ursino
Hypericum maculatum - Hipérico-malhado
Epilobium parviflorum - Epilóbio-de-flores-pequenas
Sedum album - Sedum
Prunus serotina - Cerejeira-negra
Orchis mascula - Orquídea-masculina
Ranunculus sceleratus - Ranúnculo-escelerado
Helleborus foetidus - Helléboro-fedorento
Thymus pulegioides - Tomilho
Avena sativa - Aveia
Hordeum murinum - Cevada-silvestre
Matricaria chamomilla - Camomila
Hyacinthoides non-scripta - Jacinto-dos-bosques
Malva sylvestris - Malva
Abies alba - Abeto-branco
Echinochloa crus-galli - Capim-arroz
Torilis japonica - Torilis-japonesa
Galium uliginosum - Gália-dos-pântanos
Hieracium umbellatum - Hieracium-de-umbelas
Platanthera bifolia - Platantera-de-duas-folhas
Veronica hederifolia - Veronica-hedera
Rhamnus cathartica - Espinho-cerval-de-cão
Mentha arvensis - Hortelã-dos-campos
Senecio inaequidens - Senécio
Carex remota - Cárice-remota
Euphorbia peplus - Erva-leiteira
Sanguisorba officinalis - Pimpinela-maior
Milium effusum - Milium
Epilobium ciliatum - Epilóbio-ciliado
Jasione montana - Jasione
Cruciata laevipes - Crucíata-de-caules-lisos
Hydrocotyle vulgaris - Hydrocotyle
Buddleja davidii - Budleia
Juglans regia - Nogueira
Sanguisorba minor - Pimpinela-menor
Carex canescens - Cárice-canescens
Asplenium ruta-muraria - Asplenium
Verbena officinalis - Verbena
Centaurea nigra - Centáurea-negra
Dactylorhiza fuchsii - Dactylorhiza
Sinapis arvensis - Mostarda-silvestre
Atriplex prostrata - Salsola
Prunus laurocerasus - Lauroceraso
